NO texture/block/copper_ore.xpm
SO texture/block/redstone_ore.xpm
WE texture/block/obsidian.xpm
EA texture/block/beehive_front_honey.xpm

F 101,67,33
C 128,128,128

        1111111111111111111111111
        1000000000110000000000001
        1011000001110000000000001
        1001000000000000000000001
111111111011000001110000000000001
100000000011000001110111111111111
11110111111111011100000010001
11110111111111011101010010001
11000000110101000000000100001
1000000000000001100000010001111
10000000000000001101011N10001
11000001110101011111011110001
11110111 1110101 101111010101
11111111 1111111 111111111111
