NO texture/block/tube_coral_block_s.xpm
SO texture/colors_blocks/creaking_heart_dormant_s.xpm
WE texture/colors_blocks/crimson_stem.xpm
EA texture/block/crimson_stem_s.xpm

F 101,67,33
C 128,128,128

        1111111111111111111111111
        1000000000110000000000001
        1011000001110000000000001
        1001000000000000000000001
111111111011000001110000000000001
100000000011000001110111111111111
11110111111111011100000010001
11110111111111011101010010001
11000000110101000000000100001
1000000000000001100000000001111
10000000000000001101010N00001
11000001110101011111011000001
11110111 1110101 101111010101
11111111 1111111 111111111111


