NO texture/block/gold.xpm
SO texture/block/redstone2.xpm
WE texture/block/beehive_honey.xpm
EA texture/block/coal.xpm

F 128,128,128
C 225,30,0

        1111111111111111111111111
        1000000000110000000000001
        1011000001110000000000001
        1001000000000000000000001
111111111011000001110000000000001
100000000011000001110111111111111
11110111111111011100000010001
11110111111111011101010010001
11000000110101000000000000001
1000000000000001100000010001111
10000000000000001101010010N01
11000001110101011111011110001
11110111 1110101 101111010001
11111111 1111111 111111111111
