
NO texture/block/tube_coral_block_s.xpm
SO texture/colors_blocks/creaking_heart_dormant_s.xpm
WE texture/colors_blocks/crimson_stem.xpm
EA texture/block/crimson_stem_s.xpm

F 220,100,0
C 225,30,0

11111111
10010001
10000001
10100001
11000W01
11111111
