F 220,100,0
C 225,30,0

EA texture/block/crimson_stem_s.xpm
DON texture/door/mangrove_door_top.xpm
DOE texture/door/mangrove_door_top.xpm
NO texture/block/tube_coral_block_s.xpm
SO texture/colors_blocks/creaking_heart_dormant_s.xpm
WE texture/colors_blocks/crimson_stem.xpm



        1111111111111111111111111
        1000000000110000000000001
        1011000001110000000000001
        1001000000C00000000000001
111111111011000001110000000000001
10000000001100000111C111111111111
11110000001111011100000010001
1111C111111111c111010100C0001
11000000110101011100000010001
10000000C00000000C00000010001
10000000100000001101010010001
11000001110101011111011110N0111
11110111 1110101 100011000001
11111111 1111111 111111111111

